1                                      1
1111111111111111111111111111111111111111
1              112211                  1
1                                      1
1       3      1111111111        3     1
1                                      1
1                                      1
1                                      1
1    22222222222         2222222222    1
1                                      1
1                                      1
1               11111111               1
1        3      12222221         3     1
1               11111111               1
1                                      1
1                                      1
1                                      1
1                                      1
1                                      1
1                                      1
1                                      1
1                                      1
1    2222222111111222211111222         1
1                                      1
1       222                  222       1
1       222     11111111     222       1
1                                      1
1                                      1
1                                      1
1                                      1
1                                      1
1111111111111111111111111111111111111111
1                                      1