1                                                              1
1111111111111111111111111111111111111111111111111111111111111111
1                                                              1
1                                                              1
1       1111         21    2         2    12        1111       1
1       2222         21    2         2    12        2222       1
1       2222         21    22222222222    12        2222       1
1       2222         21                   12        2222       1
1       1111         22222222111111122222222        1111       1    
1                                                              1
1                                                              1
1                 3                            3               1
1                                                              1
1       111112222211111                111112222211111         1
1       111112222211111                111112222211111         1
1       111112222211111                111112222211111         1
1                                                              1
1                                                              1
1                                                              1
11111111                     221                        11111111
1                              2                               1
1                        222   2  222                          1
1                              2                               1
11111111                       122                      11111111
1                                                              1
1                                                              1
1                                                              1
1       111122222221111                111222222222111         1
1       111122222221111                111222222222111         1
1       111122222221111                111222222222111         1
1                                                              1
1                3                                             1
1                               3                              1
1                                                              1
1       1111         22222222211111112222222        1111       1
1       2222         21                   12        2222       1    
1       2222         21    22222222222    12        2222       1
1       2222         21    2         2    12        2222       1
1       1111         21    2         2    12        1111       1
1                                                              1
1                                                              1
1                                                              1
1111111111111111111111111111111111111111111111111111111111111111
1                                                              1